$||||||||||||*
40000000000003
40000000000003
40000000000003
40000000000003
40000000000003
40000000000003
40000000000003
40000000000003
40000000000003
40000000000003
40006::::80003
4006#$||*%8003
4003$7005*4003
40034000034003
40034000034003
40034000034003
4003%8006#4003
4005*4003$7003
40003400340003
40003%86#40003
40005*43$70003
40000343400003
400003%#400003
400005||700003
%800000000006#
2%8000000006#2
22%80000006#22
222%800006#222
2222%8006#2222
22222400322222
22222411322222
