$||||7115||||*
40000000000003
40000000000003
40000000000003
40000000000003
40000000000003
40000000000003
40000000000003
40000000000003
40000000000003
40000000000003
40000000000003
40000000000003
40000000000003
40000000000005
40000000000001
40000000000001
40000000000006
40000000000003
40000000000003
40000000000003
40000000000003
40000000000003
40000000000003
40000000000003
40000000000003
40000000000003
40000000000003
40000000000003
40000000000003
40000000000003
%::::::::::::#
