$||||||||||||*
40000000000003
40000000000003
40000000000003
40000000000003
40000000000003
40000000000003
40000000000003
40000000000003
40000000000003
40000000000003
40000000000003
%:::::80000003
22222240000003
||||*2%:::806#
10003222224032
10005|||||705*
80000000000003
40000000000003
40000000000003
40000000000003
40000000000003
40000000000003
40000000000003
40000000000003
40000000000003
40000000000003
40000000000003
40000000000003
40000000000003
40000000000003
%::::::::::::#
