00000000000000
00000000000000
00000000000000
00000000000000
00000000000001
00000000000000
00000000000001
00000000000000
00000000000000
11111111111110
00000000000000
00000000000000
01111101111110
00000000000000
00000000000000
00000000000000
01111111111111
00000000000000
00100000000000
00100000000000
00100000000000
00100000000000
00100000000000
00100000000000
00100000000000
00000000000000
00000000000000
00000000000000
00000000000000
00000000000000
00000000000000
00000000000000
